Getting Started
10x10
- - - - - - - - - -
0 - - - - - - - K -
- - 0 0 - - 0 - - - 
- - - - - - - - - - 
- - - - 1 - - - - - 
- - - - - - - - - - 
- - - - - - - - - - 
- - - - - - - - - - 
- - - - - - - - - - 
- - - - - - - - - - 
