Getting Started
10x10
- - - - - - - - - -
S - - - - - - - K -
- - - - - - - - - - 
- - - - - - - - - - 
- - - - 0 - - - - - 
- - - - - - - - - - 
- - 0 - - - - - - - 
- - - - 0 - - - - - 
- - - - - - - 0 - - 
- - - - - - - - - - 
