Level FIVE
10x10
- - - - - - - - - - 
- - - - - - - - - - 
- - - - - - - - - - 
- - - - - - - - - - 
- - - K - - - - - - 
- - - - - - - - - - 
- - - - - - - - - - 
- - - - - - - - - - 
- 0 - 0 - 0 - 0 - S 
- - - - - - - - - - 
