Level SIXSIXSIX
10x10
- - - - - - - - - - 
- - - 0 - - - - - - 
- - - - - - - - - - 
- - - - - - - - - - 
- - - 0 - - 0 - - - 
- - - - - - - - - - 
- - - - - - K - 0 - 
- - - - - - - - - - 
S - - - - - - - - - 
- - - - - - - - - - 
