Level eight
10x10
- - - - - - - - - - 
- - - - - - - - - - 
S - - - - - - - - - 
- - - - - - - - - - 
- - - - - - - - - - 
- - - 0 - - - - - - 
- - 0 - - - - - K - 
- - - - - - - - - - 
- - - - - - - - - - 
- - - - - 0 - - - - 
