Level 777
10x10
- - - - - - - - - - 
- 0 - - - - - - - - 
- - - - - - - - - - 
- - - - - - - - - - 
- - - - - - - - - - 
- - - - 0 - - - - - 
- - - - - 0 - - - - 
- - - - - - 0 - - - 
- - - - - - - S - - 
K - - - - - - - - - 
